34 34 34 34 34 34 34 34 34 34 34 34 34 34 34 34 34 34 34 34 34 34 34 34 34 34 34 34 34 34 34 34 34 34 34 34 34 34 34 34 34 34 34 34 34 34 34 34 34 34 
34 34 34 34 34 34 34 34 34 34 34 34 34 34 34 34 34 34 34 34 34 34 34 34 34 34 34 34 34 34 34 34 34 34 34 34 34 34 34 34 34 34 34 34 34 34 34 34 34 34 
34 34 34 34 34 34 34 34 34 34 34 34 34 34 34 34 34 34 34 34 34 34 34 34 34 34 34 34 34 34 34 34 34 34 34 34 34 34 34 34 34 34 34 34 34 34 34 34 34 34 
34 34 34 34 34 34 34 34 34 34 34 34 34 34 34 34 34 34 34 34 34 34 34 34 34 34 34 34 34 34 34 34 34 34 34 34 34 34 34 34 34 34 34 34 34 34 34 34 34 34 
34 34 34 34 34 34 34 34 34 34 34 34 34 34 34 34 34 34 34 34 34 34 34 34 34 34 34 34 34 34 34 34 34 34 34 34 34 34 34 34 34 34 34 34 34 34 34 34 34 34 
34 34 34 34 34 34 34 34 34 34 34 34 34 34 34 34 34 34 34 34 34 34 34 34 34 34 34 34 34 34 34 34 34 34 34 34 34 34 34 34 34 34 34 34 34 34 34 34 34 34 
34 34 34 34 34 34 34 34 34 34 34 34 34 34 34 34 34 34 34 34 34 34 34 34 34 34 34 34 34 34 34 34 34 34 34 34 34 34 34 34 34 34 34 34 34 34 34 34 34 34 
34 34 34 34 34 34 34 34 34 34 34 34 36 32 32 32 32 32 32 34 34 34 34 34 34 32 32 32 32 32 32 38 32 32 32 32 32 32 32 34 34 34 34 34 34 34 34 34 34 34 
34 34 34 34 34 34 34 34 34 34 34 34 32 33 33 35 33 33 33 32 34 34 34 34 36 33 33 33 33 33 33 33 33 33 33 33 33 33 33 32 34 34 34 34 34 34 34 34 34 34 
34 34 34 34 34 34 34 34 34 34 34 32 33 33 33 33 33 33 33 32 34 34 34 32 49 33 33 33 33 33 33 33 33 33 33 33 33 33 33 46 32 34 34 34 34 34 34 34 34 34 
34 34 34 34 34 34 34 34 34 34 34 32 33 33 33 45 53 33 33 32 34 34 32 33 33 33 33 33 33 33 33 33 33 33 33 33 33 33 33 33 32 34 34 34 34 34 34 34 34 34 
34 34 34 34 34 34 34 34 34 34 32 33 33 33 33 46 49 33 33 32 34 32 33 33 33 33 33 33 33 33 33 33 33 33 33 33 33 33 33 33 36 34 34 34 34 34 34 34 34 34 
34 34 34 34 34 34 34 34 34 34 32 33 33 33 33 33 33 33 36 32 34 32 33 33 33 33 33 33 33 33 33 33 33 33 33 33 33 33 33 33 32 34 34 34 34 34 34 34 34 34 
34 34 34 34 34 34 34 34 34 34 34 32 33 33 33 33 33 33 32 34 34 32 42 33 33 33 33 33 33 33 33 33 33 33 33 33 33 33 33 32 32 34 34 34 34 34 34 34 34 34 
34 34 34 34 34 34 34 34 34 34 34 34 32 33 33 33 33 33 32 34 34 34 32 32 33 33 33 33 33 33 33 33 33 33 33 33 33 33 32 32 32 34 34 34 34 34 34 34 34 34 
34 34 34 34 34 34 34 34 34 34 34 34 36 32 33 33 33 33 36 34 34 34 34 34 32 33 33 33 33 33 33 33 33 33 33 45 53 32 36 34 34 34 34 34 34 34 34 34 34 34 
34 34 34 34 34 34 34 34 34 34 34 34 34 32 33 33 33 33 32 32 34 34 34 34 34 32 33 33 33 33 33 33 33 33 33 32 32 34 34 34 34 34 34 34 34 34 34 34 34 34 
34 34 34 34 34 34 34 34 34 34 34 34 34 32 33 33 33 33 33 32 34 34 34 34 34 34 32 33 33 33 33 33 33 54 32 34 34 34 34 34 34 34 34 34 34 34 34 34 34 34 
34 34 34 34 34 34 34 34 34 34 34 34 34 32 32 33 33 33 33 32 34 34 34 34 34 34 32 38 33 33 33 33 38 32 34 34 34 34 34 34 34 34 34 34 34 34 34 34 34 34 
34 34 34 34 34 34 34 34 34 34 34 34 34 34 34 32 33 33 33 46 32 32 37 36 32 32 32 33 33 33 33 33 33 33 32 34 34 34 34 34 34 34 34 34 34 34 34 34 34 34 
34 34 34 34 34 34 34 34 34 34 34 34 34 34 34 32 33 33 33 33 33 33 33 33 33 33 33 33 33 33 33 33 33 33 36 34 34 34 34 34 34 34 34 34 34 34 34 34 34 34 
34 34 34 34 34 34 34 34 34 34 34 34 34 34 34 32 33 33 33 33 33 33 33 33 33 33 33 33 33 33 33 33 33 33 33 32 34 34 34 34 34 34 34 34 34 34 34 34 34 34 
34 34 34 34 34 34 34 34 34 34 34 34 34 34 34 32 33 33 33 33 33 33 33 33 33 33 33 33 33 33 33 33 33 33 33 32 32 34 34 34 34 34 34 34 34 34 34 34 34 34 
34 34 34 34 34 34 34 34 34 34 34 34 34 34 34 32 33 33 33 33 33 33 33 33 33 33 33 33 33 33 33 33 33 32 32 32 34 34 34 34 34 34 34 34 34 34 34 34 34 34 
34 34 34 34 34 34 34 34 34 34 34 34 34 34 34 32 33 33 33 33 33 33 33 33 45 53 33 33 33 33 33 33 33 32 34 34 34 34 34 34 34 34 34 34 34 34 34 34 34 34 
34 34 34 34 34 34 34 34 34 34 34 34 34 34 34 32 33 33 33 33 33 33 33 33 54 49 33 33 33 33 33 32 32 34 34 34 34 34 34 34 34 34 34 34 34 34 34 34 34 34 
34 34 34 34 34 34 34 34 34 34 34 34 34 34 34 32 33 33 33 33 33 33 33 33 33 33 33 33 33 33 33 32 34 34 34 34 34 34 34 34 34 34 34 34 34 34 34 34 34 34 
34 34 34 34 34 34 34 34 34 34 34 34 34 34 34 32 33 33 33 33 33 33 33 33 33 33 33 33 33 33 33 32 32 34 34 34 34 34 34 34 34 34 34 34 34 34 34 34 34 34 
34 34 34 34 34 34 34 34 34 34 34 34 34 34 34 32 33 33 33 33 33 33 33 33 33 33 33 33 33 33 33 33 32 32 32 37 32 34 34 34 34 34 34 34 34 34 34 34 34 34 
34 34 34 34 34 34 34 34 34 34 34 34 34 34 34 36 33 33 33 33 33 33 33 33 33 33 33 33 33 33 33 33 33 33 33 33 37 32 34 34 34 34 34 34 34 34 34 34 34 34 
34 34 34 34 34 34 34 34 34 34 34 34 34 34 34 32 33 33 33 33 33 33 33 33 33 33 33 33 33 33 33 33 33 33 33 33 33 33 32 32 32 34 34 34 34 34 34 34 34 34 
34 34 34 34 34 34 34 34 34 34 34 34 34 34 34 32 33 33 33 33 33 33 33 33 33 33 33 33 33 33 33 33 33 33 33 33 33 33 33 36 32 34 34 34 34 34 34 34 34 34 
34 34 34 34 34 34 34 34 34 34 34 34 34 34 34 32 33 33 33 33 33 33 33 33 33 33 33 33 33 33 33 33 33 33 33 33 33 33 33 46 32 34 34 34 34 34 34 34 34 34 
34 34 34 34 34 34 34 34 34 34 34 34 34 34 34 32 33 33 33 33 33 33 33 33 45 36 36 33 33 33 33 33 33 33 33 33 33 33 33 33 32 34 34 34 34 34 34 34 34 34 
34 34 34 34 34 34 34 34 34 34 34 34 34 34 32 36 33 33 33 33 33 33 33 33 32 32 34 32 32 33 33 33 33 33 33 33 33 33 33 33 32 34 34 34 34 34 34 34 34 34 
34 34 34 34 34 34 34 34 34 34 34 34 34 32 36 33 33 52 51 33 33 33 33 32 34 34 34 34 34 32 33 33 33 33 33 33 33 33 33 33 32 34 34 34 34 34 34 34 34 34 
34 34 34 34 34 34 34 34 34 34 34 34 34 36 33 33 33 49 47 33 33 32 32 34 34 34 34 34 34 32 33 33 33 33 33 33 33 33 33 33 32 34 34 34 34 34 34 34 34 34 
34 34 34 34 34 34 34 34 34 34 41 32 32 32 33 33 33 33 33 33 33 32 34 34 34 34 34 34 34 34 32 33 33 33 33 33 33 33 33 33 32 34 34 34 34 34 34 34 34 34 
34 34 34 34 34 34 34 34 34 32 41 33 33 54 33 33 33 33 33 33 32 34 34 34 34 34 34 34 34 34 34 36 33 33 33 33 33 33 33 33 32 34 34 34 34 34 34 34 34 34 
34 34 34 34 34 34 34 34 34 32 33 33 33 33 33 33 33 33 33 33 32 34 34 34 34 34 34 34 34 34 34 34 32 33 33 33 33 33 33 33 32 34 34 34 34 34 34 34 34 34 
34 34 34 34 34 34 34 34 34 32 33 33 33 33 33 33 33 33 33 45 32 34 34 34 34 34 34 34 34 34 34 34 32 32 33 33 33 33 33 33 32 34 34 34 34 34 34 34 34 34 
34 34 34 34 34 34 34 34 34 34 36 32 32 32 32 32 32 32 32 32 34 34 34 34 34 34 34 34 34 34 34 34 34 34 32 32 32 32 32 36 32 34 34 34 34 34 34 34 34 34 
34 34 34 34 34 34 34 34 34 34 34 34 34 34 34 34 34 34 34 34 34 34 34 34 34 34 34 34 34 34 34 34 34 34 34 34 34 34 34 34 34 34 34 34 34 34 34 34 34 34 
34 34 34 34 34 34 34 34 34 34 34 34 34 34 34 34 34 34 34 34 34 34 34 34 34 34 34 34 34 34 34 34 34 34 34 34 34 34 34 34 34 34 34 34 34 34 34 34 34 34 
34 34 34 34 34 34 34 34 34 34 34 34 34 34 34 34 34 34 34 34 34 34 34 34 34 34 34 34 34 34 34 34 34 34 34 34 34 34 34 34 34 34 34 34 34 34 34 34 34 34 
34 34 34 34 34 34 34 34 34 34 34 34 34 34 34 34 34 34 34 34 34 34 34 34 34 34 34 34 34 34 34 34 34 34 34 34 34 34 34 34 34 34 34 34 34 34 34 34 34 34 
34 34 34 34 34 34 34 34 34 34 34 34 34 34 34 34 34 34 34 34 34 34 34 34 34 34 34 34 34 34 34 34 34 34 34 34 34 34 34 34 34 34 34 34 34 34 34 34 34 34 
34 34 34 34 34 34 34 34 34 34 34 34 34 34 34 34 34 34 34 34 34 34 34 34 34 34 34 34 34 34 34 34 34 34 34 34 34 34 34 34 34 34 34 34 34 34 34 34 34 34 
34 34 34 34 34 34 34 34 34 34 34 34 34 34 34 34 34 34 34 34 34 34 34 34 34 34 34 34 34 34 34 34 34 34 34 34 34 34 34 34 34 34 34 34 34 34 34 34 34 34 
34 34 34 34 34 34 34 34 34 34 34 34 34 34 34 34 34 34 34 34 34 34 34 34 34 34 34 34 34 34 34 34 34 34 34 34 34 34 34 34 34 34 34 34 34 34 34 34 34 34 
