5 5 5 5 5 5 5 5 5 5 5 5 5 5 5 5 5 5 5 5 5 5 5 5 5 5 5 5 5 5 5 5 5 5 5 5 5 5 5 5 5 5 5 5 5 5 5 5 5 5 
5 5 5 5 5 5 5 5 5 5 5 5 5 5 5 5 5 5 5 5 5 5 5 5 5 5 5 5 5 5 5 5 5 5 5 5 5 5 5 5 5 5 5 5 5 5 5 5 5 5 
5 4 4 4 5 5 4 4 4 5 5 5 5 5 5 5 5 5 4 4 5 5 5 5 5 5 5 4 4 4 4 5 5 5 5 5 5 5 5 5 5 5 5 5 5 5 5 5 5 5 
5 4 5 5 5 5 5 5 5 5 5 4 5 5 5 5 5 5 5 4 5 5 5 5 5 5 5 5 5 4 4 4 4 5 5 5 5 5 5 5 5 5 5 5 5 5 5 5 5 5 
5 4 5 5 5 5 5 5 5 5 5 5 5 5 5 5 5 5 5 4 5 5 5 5 5 5 5 5 5 5 5 5 5 5 5 5 5 5 5 5 5 5 5 5 5 5 5 5 5 5 
5 4 4 5 5 5 5 5 5 5 5 5 5 5 5 5 5 5 5 5 5 5 5 5 5 5 5 5 5 5 5 5 5 5 5 5 5 5 5 4 4 4 5 5 5 5 5 5 5 5 
5 5 5 5 5 5 5 5 5 5 5 5 5 5 4 4 4 5 5 5 5 5 5 5 5 5 5 5 5 5 5 5 5 5 5 5 5 5 4 5 5 4 5 5 5 5 5 5 5 5 
5 5 5 5 5 5 5 5 5 5 5 5 5 5 4 4 4 4 5 5 5 5 5 5 5 5 5 5 5 5 4 4 4 5 5 5 5 5 5 5 5 5 5 4 5 5 5 5 4 5 
5 5 5 5 5 5 5 5 5 5 5 5 5 5 5 5 5 5 5 5 5 5 5 5 5 5 5 4 4 4 4 5 5 5 5 5 5 5 5 5 5 5 5 4 4 5 5 5 4 5 
5 5 5 5 5 5 5 5 5 5 2 2 2 2 2 2 2 2 2 2 2 2 2 2 2 2 2 2 2 3 1 1 1 1 1 2 1 1 1 4 5 5 5 5 4 5 5 5 4 4 
5 5 5 5 5 5 5 5 5 5 2 2 2 2 2 1 1 1 1 2 2 2 2 2 2 2 2 2 2 3 1 1 1 1 1 1 1 1 1 5 5 5 5 5 5 5 5 5 5 4 
5 5 5 5 5 5 5 5 5 5 2 2 1 1 2 2 2 2 2 2 2 2 2 2 2 2 2 2 2 3 1 1 1 1 1 1 1 1 2 5 5 5 5 5 5 5 5 5 5 5 
5 5 5 5 5 4 5 5 5 5 2 2 1 2 2 2 2 2 2 2 2 2 2 2 2 2 1 2 2 3 1 1 1 1 1 1 1 2 2 5 5 5 5 5 5 5 5 5 5 5 
5 5 5 5 5 4 5 5 5 5 2 2 2 2 2 2 2 2 2 2 2 2 2 2 2 2 1 2 2 3 1 1 1 1 1 1 1 2 2 5 5 5 5 5 5 5 5 5 5 5 
5 5 5 5 5 4 4 5 5 5 2 2 2 2 2 2 2 2 2 1 1 2 2 2 2 2 1 2 2 3 2 1 1 1 1 2 2 2 2 5 5 5 5 5 5 5 5 5 5 5 
5 5 5 5 5 5 5 5 5 5 2 2 2 2 2 2 2 2 2 2 1 1 1 2 2 2 2 2 2 3 3 3 0 0 3 3 3 3 3 5 5 5 5 5 5 5 5 5 5 5 
5 4 5 5 5 5 5 5 5 5 2 2 2 2 2 2 2 2 2 2 2 2 2 2 2 2 2 2 2 2 2 0 0 0 2 2 2 2 2 5 5 5 5 5 5 5 5 5 5 5 
5 5 5 5 5 5 5 5 5 5 2 2 2 2 1 1 1 1 2 2 2 2 2 2 2 2 2 2 2 2 0 0 0 2 2 2 2 2 2 5 5 5 5 5 5 4 4 5 4 4 
5 5 5 5 5 5 5 5 5 5 2 2 2 2 2 2 2 2 2 2 2 2 2 2 2 2 2 2 2 2 0 0 2 2 2 2 2 2 2 5 5 5 5 5 5 5 5 5 5 5 
5 5 5 5 5 5 5 5 5 5 2 2 2 2 2 2 2 2 2 2 2 2 2 2 2 2 2 0 0 0 0 0 2 2 2 2 2 2 2 5 5 5 4 5 5 5 5 5 5 5 
5 5 5 5 5 5 5 5 5 5 2 2 2 2 2 2 2 2 2 2 2 2 2 2 2 2 2 0 2 2 2 2 2 2 2 2 2 2 2 5 5 5 4 5 5 5 5 5 5 5 
5 5 5 5 5 5 5 5 5 5 2 2 2 2 2 2 2 2 2 2 2 2 2 2 2 2 2 0 2 2 2 2 2 2 2 2 2 2 2 5 5 5 4 5 5 5 5 5 5 5 
5 5 5 5 5 5 5 5 5 5 2 2 2 2 2 2 2 2 2 2 2 2 2 2 2 2 0 0 2 2 2 2 2 2 2 2 2 2 2 5 5 5 5 4 5 5 5 5 5 5 
5 5 5 4 5 5 5 5 5 5 2 2 2 1 1 1 2 2 2 2 2 2 2 0 0 0 0 2 2 2 2 2 2 2 1 1 1 2 2 5 5 5 5 5 4 4 5 5 5 5 
5 5 5 4 5 5 5 5 5 5 2 2 2 2 2 2 2 2 2 2 2 2 0 0 2 2 2 2 2 2 2 2 2 2 2 2 2 2 2 5 5 5 5 5 5 5 4 4 4 4 
5 5 4 5 5 5 5 5 5 5 2 2 2 2 2 2 2 2 2 2 2 2 0 2 1 2 1 1 2 2 2 2 2 2 2 2 2 2 2 5 5 5 5 5 5 5 5 5 5 5 
5 5 4 5 5 5 5 5 5 5 2 2 2 2 2 1 1 2 2 2 2 2 0 2 2 2 2 2 2 2 2 2 2 2 2 2 2 2 2 5 5 5 5 5 5 5 5 5 5 5 
5 5 4 5 5 5 5 5 5 5 2 2 1 2 2 1 2 2 2 2 2 0 0 2 2 1 2 2 2 2 2 2 2 2 2 2 2 2 2 5 5 5 5 5 5 5 5 5 5 5 
5 5 5 5 5 5 5 5 5 5 2 2 1 2 2 2 2 2 0 0 0 0 2 2 1 1 2 2 2 2 2 2 2 2 2 2 2 2 2 5 5 5 5 5 5 5 5 5 5 5 
5 5 5 5 5 5 5 5 5 5 2 2 1 2 2 2 2 2 0 2 2 2 2 2 2 2 2 2 2 2 2 2 2 1 1 1 2 2 2 5 5 5 5 5 5 5 5 5 5 5 
5 5 5 5 5 5 5 5 5 5 2 2 1 2 1 1 1 1 0 2 2 2 2 2 2 2 2 2 2 2 2 2 2 1 2 2 2 2 2 5 5 5 4 4 4 4 4 4 4 5 
5 5 5 5 5 5 5 5 5 5 2 2 2 2 2 2 2 2 0 2 2 2 2 1 2 2 2 2 2 2 2 2 2 2 2 2 2 2 2 5 5 4 5 5 4 5 5 4 4 5 
5 5 5 4 4 5 5 5 5 5 2 2 2 2 2 2 2 0 0 2 2 2 2 1 2 2 2 2 2 2 2 2 2 2 2 2 2 2 2 5 5 4 5 5 5 5 5 4 5 5 
5 5 4 4 5 5 5 5 5 5 2 2 2 2 2 0 0 0 2 2 2 2 2 2 2 2 2 2 2 2 2 2 2 2 2 2 2 2 2 5 5 4 4 5 5 5 5 4 5 5 
5 5 4 5 5 5 5 5 5 5 2 2 2 2 2 0 1 2 2 2 2 2 2 2 2 1 2 2 2 2 2 2 2 2 2 2 2 2 2 5 5 5 4 4 4 4 4 4 5 5 
5 5 4 5 5 5 5 5 5 5 2 2 2 2 0 0 1 2 2 2 2 2 2 2 2 2 1 2 2 2 2 2 2 2 2 1 2 2 2 5 5 5 5 5 5 5 4 5 5 5 
5 5 4 5 5 5 5 5 5 5 2 2 2 0 0 2 2 2 2 2 2 2 2 2 2 2 1 2 2 2 2 2 2 2 1 1 2 2 2 5 5 5 5 5 5 5 5 5 5 5 
5 5 4 5 5 5 5 5 5 5 2 2 2 0 2 2 2 2 2 2 2 2 2 2 2 2 2 2 2 2 2 2 2 2 1 2 2 2 2 5 5 5 5 5 5 5 5 5 5 5 
5 5 4 4 5 5 5 5 5 5 2 2 0 0 2 2 1 2 1 2 2 2 2 2 2 2 2 2 2 2 2 2 2 2 2 2 2 2 2 5 5 5 5 5 5 5 5 5 5 5 
5 5 5 5 5 5 5 5 5 5 2 0 0 2 2 2 2 2 2 2 2 2 2 2 1 1 1 1 2 2 2 2 2 2 2 2 2 2 2 4 4 5 5 5 5 5 5 5 5 5 
5 5 5 5 5 5 5 5 5 5 0 0 2 2 2 2 2 2 2 2 1 2 2 2 2 2 2 2 2 2 2 2 2 2 2 2 2 2 1 5 5 5 5 5 5 5 5 5 5 5 
5 5 5 5 5 5 5 5 5 5 5 5 5 5 5 5 5 5 5 5 5 5 5 5 5 5 5 5 5 5 5 5 5 5 5 5 5 5 5 5 5 5 5 5 5 5 5 5 5 5 
5 5 5 4 5 5 5 5 4 4 5 5 5 5 5 5 5 5 5 5 5 5 5 5 5 5 5 5 5 5 5 5 5 5 5 4 5 5 5 5 5 5 5 5 5 5 5 5 5 5 
5 5 4 4 5 5 5 5 4 5 5 5 5 5 5 5 5 5 5 5 5 5 5 5 5 5 5 5 5 5 5 4 4 5 5 5 5 5 5 5 5 4 4 5 5 5 5 5 5 5 
5 5 4 5 5 5 5 4 5 5 5 5 5 5 5 5 5 5 5 5 5 5 4 4 4 4 4 5 5 5 5 5 5 5 5 5 5 5 5 5 4 4 4 4 4 4 4 4 4 4 
5 5 4 5 5 5 5 4 5 5 5 5 5 5 5 5 5 5 5 5 5 5 5 5 5 4 4 5 5 5 5 5 5 5 5 5 5 5 5 5 4 5 5 5 4 5 5 5 5 4 
5 5 5 5 5 5 5 4 5 5 5 4 5 5 5 5 5 5 5 5 5 5 5 5 5 4 5 5 5 5 5 5 5 5 5 5 5 5 5 5 4 4 5 5 5 5 5 5 4 4 
5 5 5 5 5 5 5 5 4 4 4 5 5 5 5 5 5 5 5 5 5 5 5 5 5 5 5 5 5 5 5 5 5 5 5 5 5 5 5 5 5 4 4 5 5 5 5 4 4 5 
5 5 5 5 5 5 5 5 5 4 5 5 5 5 5 5 5 5 5 5 5 5 5 5 5 5 5 5 5 4 4 4 5 5 5 5 5 5 5 5 5 5 4 4 4 4 5 5 5 5 
5 5 5 5 5 5 5 5 5 5 5 5 5 5 5 5 5 5 5 5 5 5 5 5 5 5 5 5 5 5 5 4 4 5 5 5 5 5 5 5 5 5 5 5 4 4 5 5 5 5 
