5 5 5 5 5 5 5 5 5 5 5 5 5 5 5 5 5 5 5 5 5 5 5 5 5 5 5 5 5 5 5 5 5 5 5 5 5 5 5 5 5 5 5 5 5 5 5 5 5 5 
5 5 5 5 5 5 5 5 5 5 5 5 5 5 5 5 5 5 5 5 5 5 5 5 5 5 5 5 5 5 5 5 5 5 5 5 5 5 5 5 5 5 5 5 5 5 5 5 5 5 
5 4 4 4 5 5 4 4 4 5 5 5 5 5 5 5 5 5 4 4 5 5 5 5 5 5 5 4 4 4 4 5 5 5 5 5 5 5 5 5 5 5 5 5 5 5 5 5 5 5 
5 4 5 5 5 5 5 5 5 5 5 4 5 5 5 5 5 5 5 4 5 5 5 5 5 5 5 5 5 4 4 4 4 5 5 5 5 5 5 5 5 5 5 5 5 5 5 5 5 5 
5 4 5 5 5 5 5 5 5 5 5 5 5 5 5 5 5 5 5 4 5 5 5 5 5 5 5 5 5 5 5 5 5 5 5 5 5 5 5 5 5 5 5 5 5 5 5 5 5 5 
5 4 4 5 5 5 5 5 5 5 5 5 5 5 5 5 5 5 5 5 5 5 5 5 5 5 5 5 5 5 5 5 5 5 5 5 5 5 5 4 4 4 5 5 5 5 5 5 5 5 
5 5 5 5 5 5 5 5 5 5 5 5 5 5 4 4 4 5 5 5 5 5 5 5 5 5 5 5 5 5 5 5 5 5 5 5 5 5 4 5 5 4 5 5 5 5 5 5 5 5 
5 5 5 5 5 5 5 5 5 5 5 5 5 5 4 4 4 4 5 5 5 5 5 5 5 5 5 5 5 5 4 4 4 5 5 5 5 5 5 5 5 5 5 4 5 5 5 5 4 5 
5 5 5 5 5 5 5 5 5 5 5 5 5 5 5 5 5 5 5 5 5 5 5 5 5 5 5 4 4 4 4 5 5 5 5 5 5 5 5 5 5 5 5 4 4 5 5 5 4 5 
5 5 5 5 5 5 5 5 5 5 6 18 18 18 18 18 18 18 18 18 18 18 18 18 18 18 18 18 18 18 18 18 18 18 18 18 18 18 7 4 5 5 5 5 4 5 5 5 4 4 
5 5 5 5 5 5 5 5 5 5 16 2 2 2 2 1 1 1 1 2 2 2 2 2 2 2 2 2 2 3 3 3 3 3 3 3 3 3 14 5 5 5 5 5 5 5 5 5 5 4 
5 5 5 5 5 5 5 5 5 5 16 2 1 1 23 2 2 2 2 2 2 2 23 2 2 2 2 2 2 3 1 1 1 1 1 1 1 3 14 5 5 5 5 5 5 5 5 5 5 5 
5 5 5 5 5 4 5 5 5 5 16 2 1 2 2 2 2 2 2 2 2 2 2 2 2 2 1 2 2 3 1 1 1 1 1 1 1 3 14 5 5 5 5 5 5 5 5 5 5 5 
5 5 5 5 5 4 5 5 5 5 16 2 2 2 2 2 2 2 2 2 2 2 2 2 2 2 1 2 2 3 1 1 1 1 1 1 1 3 14 5 5 5 5 5 5 5 5 5 5 5 
5 5 5 5 5 4 4 5 5 5 16 2 2 2 2 2 23 2 2 1 1 2 2 2 2 2 1 2 2 3 2 1 24 24 1 2 2 3 14 5 5 5 5 5 5 5 5 5 5 5 
5 5 5 5 5 5 5 5 5 5 16 2 2 2 2 2 2 2 2 2 1 1 1 2 2 2 2 2 2 3 3 3 0 0 3 3 3 3 14 5 5 5 5 5 5 5 5 5 5 5 
5 4 5 5 5 5 5 5 5 5 16 2 2 2 2 2 2 2 2 2 2 2 2 2 2 2 2 2 2 2 28 0 0 0 27 2 2 2 14 5 5 5 5 5 5 5 5 5 5 5 
5 5 5 5 5 5 5 5 5 5 16 2 2 2 1 1 1 1 2 2 2 2 2 2 23 2 2 2 2 28 0 0 0 30 2 2 23 2 14 5 5 5 5 5 5 4 4 5 4 4 
5 5 5 5 5 5 5 5 5 5 16 2 2 2 2 2 2 2 2 2 2 2 2 2 2 2 2 24 28 0 0 0 30 2 2 2 2 2 14 5 5 5 5 5 5 5 5 5 5 5 
5 5 5 5 5 5 5 5 5 5 16 2 2 2 2 2 23 2 2 2 2 2 2 2 2 2 28 0 0 0 0 30 2 2 2 2 2 2 14 5 5 5 4 5 5 5 5 5 5 5 
5 5 5 5 5 5 5 5 5 5 16 2 2 2 2 2 2 2 2 2 2 2 2 2 2 25 0 0 0 30 26 2 2 2 2 2 2 2 14 5 5 5 4 5 5 5 5 5 5 5 
5 5 5 5 5 5 5 5 5 5 16 2 2 2 23 2 2 2 2 2 2 2 2 2 2 28 0 0 30 2 2 2 23 2 2 2 2 2 14 5 5 5 4 5 5 5 5 5 5 5 
5 5 5 5 5 5 5 5 5 5 16 2 2 2 2 2 2 2 2 2 2 2 2 2 28 0 0 0 27 2 2 2 2 2 2 2 2 2 14 5 5 5 5 4 5 5 5 5 5 5 
5 5 5 4 5 5 5 5 5 5 16 2 2 1 1 1 2 2 2 23 2 2 2 28 0 0 0 0 31 2 2 2 2 2 1 1 1 2 14 5 5 5 5 5 4 4 5 5 5 5 
5 5 5 4 5 5 5 5 5 5 16 2 2 2 2 2 2 2 2 2 2 2 28 0 0 0 0 0 0 31 2 2 2 2 23 2 2 2 14 5 5 5 5 5 5 5 4 4 4 4 
5 5 4 5 5 5 5 5 5 5 16 2 2 2 2 2 2 2 2 2 2 28 0 0 0 0 0 0 0 0 31 2 2 2 2 2 2 2 14 5 5 5 5 5 5 5 5 5 5 5 
5 5 4 5 5 5 5 5 5 5 16 2 2 2 2 1 1 2 2 2 25 0 0 0 0 0 0 0 0 0 0 27 2 2 2 2 2 23 14 5 5 5 5 5 5 5 5 5 5 5 
5 5 4 5 5 5 5 5 5 5 16 2 1 2 2 1 2 2 2 2 25 0 0 0 0 0 0 0 0 0 0 27 2 2 2 2 23 23 14 5 5 5 5 5 5 5 5 5 5 5 
5 5 5 5 5 5 5 5 5 5 16 2 1 2 1 2 23 2 1 2 23 29 0 0 0 0 0 0 0 0 0 31 24 24 23 23 23 2 14 5 5 5 5 5 5 5 5 5 5 5 
5 5 5 5 5 5 5 5 5 5 16 2 1 23 1 2 2 1 1 1 1 1 29 0 0 0 0 0 0 0 0 0 0 0 31 1 2 2 14 5 5 5 5 5 5 5 5 5 5 5 
5 5 5 5 5 5 5 5 5 5 16 2 1 1 11 12 12 12 12 12 12 13 1 29 0 0 0 0 0 0 0 0 0 0 0 27 1 2 14 5 5 5 4 4 4 4 4 4 4 5 
5 5 5 5 5 5 5 5 5 5 16 2 1 1 14 5 5 5 5 5 5 16 1 1 29 0 0 30 26 26 26 26 29 0 0 27 2 2 14 5 5 4 5 5 4 5 5 4 4 5 
5 5 5 4 4 5 5 5 5 5 16 2 23 23 14 5 5 5 5 5 5 16 1 1 2 26 26 2 2 2 23 23 23 26 26 1 2 2 14 5 5 4 5 5 5 5 5 4 5 5 
5 5 4 4 5 5 5 5 5 5 16 2 1 23 14 5 5 5 5 5 5 16 1 2 2 2 2 2 2 23 2 2 2 2 2 2 23 2 14 5 5 4 4 5 5 5 5 4 5 5 
5 5 4 5 5 5 5 5 5 5 16 2 1 1 14 5 5 5 5 5 5 16 1 2 2 1 2 2 23 2 2 2 2 2 2 2 2 2 14 5 5 5 4 4 4 4 4 4 5 5 
5 5 4 5 5 5 5 5 5 5 16 2 1 1 14 5 5 5 5 5 5 16 1 2 8 23 23 23 2 2 2 1 2 2 2 1 2 2 14 15 5 5 5 5 5 5 4 5 5 5 
5 5 4 5 5 5 5 5 5 5 16 2 1 1 17 18 18 18 18 18 18 19 1 23 1 2 1 2 2 2 2 2 2 2 1 1 2 2 14 5 5 5 5 5 5 5 5 5 5 5 
5 5 4 5 5 5 5 5 5 5 16 2 1 1 1 2 23 2 1 1 23 23 23 23 2 2 2 2 2 2 2 2 2 2 1 2 8 2 14 5 5 5 5 5 5 5 5 5 5 5 
5 5 4 4 5 5 5 5 5 5 16 2 1 2 1 23 2 1 1 1 1 1 2 2 2 2 2 2 2 2 2 1 2 2 23 2 2 2 14 5 5 5 5 5 5 5 5 5 5 5 
5 5 5 5 5 5 5 5 5 5 16 1 1 2 23 2 1 1 1 2 2 2 2 2 1 1 1 2 2 2 2 2 2 2 2 2 2 2 14 4 4 5 5 5 5 5 5 5 5 5 
5 5 5 5 5 5 5 5 5 5 9 12 12 12 12 12 12 12 12 12 12 12 12 12 12 12 12 12 12 12 12 12 12 12 12 12 12 12 10 5 5 5 5 5 5 5 5 5 5 5 
5 5 5 5 5 5 5 5 5 5 5 5 5 5 5 5 5 5 5 5 5 5 5 5 5 5 5 5 5 5 5 5 5 5 5 5 5 5 5 5 5 5 5 5 5 5 5 5 5 5 
5 5 5 4 5 5 5 5 4 4 5 5 5 5 5 5 5 5 5 5 5 5 5 5 5 5 5 5 5 5 5 5 5 5 5 4 5 5 5 5 5 5 5 5 5 5 5 5 5 5 
5 5 4 4 5 5 5 5 4 5 5 5 5 5 5 5 5 5 5 5 5 5 5 5 5 5 5 5 5 5 5 4 4 5 5 5 5 5 5 5 5 4 4 5 5 5 5 5 5 5 
5 5 4 5 5 5 5 4 5 5 5 5 5 5 5 5 5 5 5 5 5 5 4 4 4 4 4 5 5 5 5 5 5 5 5 5 5 5 5 5 4 4 4 4 4 4 4 4 4 4 
5 5 4 5 5 5 5 4 5 5 5 5 5 5 5 5 5 5 5 5 5 5 5 5 5 4 4 5 5 5 5 5 5 5 5 5 5 5 5 5 4 5 5 5 4 5 5 5 5 4 
5 5 5 5 5 5 5 4 5 5 5 4 5 5 5 5 5 5 5 5 5 5 5 5 5 4 5 5 5 5 5 5 5 5 5 5 5 5 5 5 4 4 5 5 5 5 5 5 4 4 
5 5 5 5 5 5 5 5 4 4 4 5 5 5 5 5 5 5 5 5 5 5 5 5 5 5 5 5 5 5 5 5 5 5 5 5 5 5 5 5 5 4 4 5 5 5 5 4 4 5 
5 5 5 5 5 5 5 5 5 4 5 5 5 5 5 5 5 5 5 5 5 5 5 5 5 5 5 5 5 4 4 4 5 5 5 5 5 5 5 5 5 5 4 4 4 4 5 5 5 5 
5 5 5 5 5 5 5 5 5 5 5 5 5 5 5 5 5 5 5 5 5 5 5 5 5 5 5 5 5 5 5 4 4 5 5 5 5 5 5 5 5 5 5 5 4 4 5 5 5 5 
