5 5 5 5 5 5 5 5 5 5 5 5 5 5 5 5 5 5 5 5 5 5 5 5 5 5 5 5 5 5 5 5 5 5 5 5 5 5 5 5 5 5 5 5 5 5 5 5 5 5 
5 5 5 5 5 5 5 5 5 5 5 5 5 5 5 5 5 5 5 5 5 5 5 5 5 5 5 5 5 5 5 5 5 5 5 5 5 5 5 5 5 5 5 5 5 5 5 5 5 5 
5 4 4 4 5 5 4 4 4 5 5 5 5 5 5 5 5 5 4 4 5 5 5 5 5 5 5 4 4 4 4 5 5 5 5 5 5 5 5 5 5 5 5 5 5 5 5 5 5 5 
5 4 5 5 5 5 5 5 5 5 5 4 5 5 5 5 5 5 5 4 5 5 5 5 5 5 5 5 5 4 4 4 4 5 5 5 5 5 5 5 5 5 5 5 5 5 5 5 5 5 
5 4 5 5 5 5 5 5 5 5 5 5 5 5 5 5 5 5 5 4 5 5 5 5 5 5 5 5 5 5 5 5 5 5 5 5 5 5 5 5 5 5 5 5 5 5 5 5 5 5 
5 4 4 5 5 5 5 5 5 5 5 5 5 5 5 5 5 5 5 5 5 5 5 5 5 5 5 5 5 5 5 5 5 5 5 5 5 5 5 4 4 4 5 5 5 5 5 5 5 5 
5 5 5 5 5 5 5 5 5 5 5 5 5 5 4 4 4 5 5 5 5 5 5 5 5 5 5 5 5 5 5 5 5 5 5 5 5 5 4 5 5 4 5 5 5 5 5 5 5 5 
5 5 5 5 5 5 5 5 5 5 5 5 5 5 4 4 4 4 5 5 5 5 5 5 5 5 5 5 5 5 4 4 4 5 5 5 5 5 5 5 5 5 5 4 5 5 5 5 4 5 
5 5 5 5 5 5 5 5 5 5 5 5 5 5 5 5 5 5 5 5 5 5 5 5 5 5 5 4 4 4 4 5 5 5 5 5 5 5 5 5 5 5 5 4 4 5 5 5 4 5 
5 5 5 5 5 5 5 5 5 5 15 10 10 10 10 10 10 10 10 10 10 10 10 10 10 10 10 10 10 10 10 10 10 10 10 10 10 10 16 4 5 5 5 5 4 5 5 5 4 4 
5 5 5 5 5 5 5 5 5 5 8 2 2 2 2 1 1 1 1 2 2 2 2 2 2 2 2 2 2 3 3 3 3 3 3 3 3 3 6 5 5 5 5 5 5 5 5 5 5 4 
5 5 5 5 5 5 5 5 5 5 8 2 1 1 23 2 2 2 2 2 2 2 23 2 2 2 2 2 2 3 1 1 1 1 1 1 1 3 6 5 5 5 5 5 5 5 5 5 5 5 
5 5 5 5 5 4 5 5 5 5 8 2 1 2 2 2 2 2 2 2 2 2 2 2 2 2 1 2 2 3 1 1 1 1 1 1 1 3 6 5 5 5 5 5 5 5 5 5 5 5 
5 5 5 5 5 4 5 5 5 5 8 2 2 2 2 2 2 2 2 2 2 2 2 2 2 2 1 2 2 3 1 1 1 1 1 1 1 3 6 5 5 5 5 5 5 5 5 5 5 5 
5 5 5 5 5 4 4 5 5 5 8 2 2 2 2 2 23 2 2 1 1 2 2 2 2 2 1 2 2 3 2 1 1 1 1 2 2 3 6 5 5 5 5 5 5 5 5 5 5 5 
5 5 5 5 5 5 5 5 5 5 8 2 2 2 2 2 2 2 2 2 1 1 1 2 2 2 2 2 2 3 3 3 0 0 3 3 3 3 6 5 5 5 5 5 5 5 5 5 5 5 
5 4 5 5 5 5 5 5 5 5 8 2 2 2 2 2 2 2 2 2 2 2 2 2 2 2 2 2 2 2 2 0 0 0 2 2 2 2 6 5 5 5 5 5 5 5 5 5 5 5 
5 5 5 5 5 5 5 5 5 5 8 2 2 2 1 1 1 1 2 2 2 2 2 2 23 2 2 2 2 2 0 0 0 2 2 2 23 2 6 5 5 5 5 5 5 4 4 5 4 4 
5 5 5 5 5 5 5 5 5 5 8 2 2 2 2 2 2 2 2 2 2 2 2 2 2 2 2 2 2 0 0 0 2 2 2 2 2 2 6 5 5 5 5 5 5 5 5 5 5 5 
5 5 5 5 5 5 5 5 5 5 8 2 2 2 2 2 23 2 2 2 2 2 2 2 2 2 2 0 0 0 0 2 2 2 2 2 2 2 6 5 5 5 4 5 5 5 5 5 5 5 
5 5 5 5 5 5 5 5 5 5 8 2 2 2 2 2 2 2 2 2 2 2 2 2 2 2 0 0 0 2 2 2 2 2 2 2 2 2 6 5 5 5 4 5 5 5 5 5 5 5 
5 5 5 5 5 5 5 5 5 5 8 2 2 2 23 2 2 2 2 2 2 2 2 2 2 2 0 0 2 2 2 2 23 2 2 2 2 2 6 5 5 5 4 5 5 5 5 5 5 5 
5 5 5 5 5 5 5 5 5 5 8 2 2 2 2 2 2 2 2 2 2 2 2 2 2 0 0 2 2 2 2 2 2 2 2 2 2 2 6 5 5 5 5 4 5 5 5 5 5 5 
5 5 5 4 5 5 5 5 5 5 8 2 2 1 1 1 2 2 2 23 2 2 2 2 0 0 0 0 2 2 2 2 2 2 1 1 1 2 6 5 5 5 5 5 4 4 5 5 5 5 
5 5 5 4 5 5 5 5 5 5 8 2 2 2 2 2 2 2 2 2 2 2 2 0 0 0 0 0 0 2 2 2 2 2 23 2 2 2 6 5 5 5 5 5 5 5 4 4 4 4 
5 5 4 5 5 5 5 5 5 5 8 2 2 2 2 2 2 2 2 2 2 2 0 0 0 0 0 0 0 0 2 2 2 2 2 2 2 2 6 5 5 5 5 5 5 5 5 5 5 5 
5 5 4 5 5 5 5 5 5 5 8 2 2 2 2 1 1 2 2 2 2 0 0 0 0 0 0 0 0 0 0 2 2 2 2 2 2 23 6 5 5 5 5 5 5 5 5 5 5 5 
5 5 4 5 5 5 5 5 5 5 8 2 1 2 2 1 2 2 2 2 1 0 0 0 0 0 0 0 0 0 0 2 2 2 2 2 23 23 6 5 5 5 5 5 5 5 5 5 5 5 
5 5 5 5 5 5 5 5 5 5 8 2 1 2 1 2 23 2 1 2 23 2 0 0 0 0 0 0 0 0 2 2 2 2 23 23 23 2 6 5 5 5 5 5 5 5 5 5 5 5 
5 5 5 5 5 5 5 5 5 5 8 2 1 23 1 2 2 1 1 1 1 1 2 0 0 0 0 0 0 0 0 0 0 0 23 23 2 2 6 5 5 5 5 5 5 5 5 5 5 5 
5 5 5 5 5 5 5 5 5 5 8 2 1 1 20 21 21 21 21 21 21 22 1 2 0 0 0 0 2 0 0 0 0 0 0 23 1 2 6 5 5 5 4 4 4 4 4 4 4 5 
5 5 5 5 5 5 5 5 5 5 8 2 1 1 6 7 7 7 7 7 7 8 1 1 2 0 0 2 2 2 2 2 23 0 0 2 2 2 6 5 5 4 5 5 4 5 5 4 4 5 
5 5 5 4 4 5 5 5 5 5 8 2 23 23 6 7 7 7 7 7 7 8 1 1 2 1 2 2 2 2 23 23 2 1 2 2 2 2 6 5 5 4 5 5 5 5 5 4 5 5 
5 5 4 4 5 5 5 5 5 5 8 2 1 23 6 7 7 7 7 7 7 8 1 2 2 2 2 2 2 23 23 2 2 2 2 2 23 2 6 5 5 4 4 5 5 5 5 4 5 5 
5 5 4 5 5 5 5 5 5 5 8 2 1 1 6 7 7 7 7 7 7 8 1 2 2 1 2 2 23 23 23 2 2 2 2 2 2 2 6 5 5 5 4 4 4 4 4 4 5 5 
5 5 4 5 5 5 5 5 5 5 8 2 1 1 6 7 7 7 7 7 7 8 1 2 17 2 1 23 23 23 23 1 2 2 2 1 2 2 6 5 5 5 5 5 5 5 4 5 5 5 
5 5 4 5 5 5 5 5 5 5 8 2 1 1 9 10 10 10 10 10 10 11 1 2 1 2 1 23 23 23 23 2 2 2 1 1 2 2 6 5 5 5 5 5 5 5 5 5 5 5 
5 5 4 5 5 5 5 5 5 5 8 2 1 1 1 2 23 2 1 1 23 1 1 23 2 2 2 23 23 23 23 2 2 2 1 2 17 2 6 5 5 5 5 5 5 5 5 5 5 5 
5 5 4 4 5 5 5 5 5 5 8 2 1 2 1 23 2 1 1 1 1 1 2 2 2 2 2 23 23 23 23 2 2 2 23 2 2 2 6 5 5 5 5 5 5 5 5 5 5 5 
5 5 5 5 5 5 5 5 5 5 8 1 1 2 2 2 1 1 1 2 2 2 2 2 1 1 1 23 23 23 23 2 2 2 2 2 2 2 6 4 4 5 5 5 5 5 5 5 5 5 
5 5 5 5 5 5 5 5 5 5 18 21 21 21 21 21 21 21 21 21 21 21 21 21 21 21 21 21 21 21 21 21 21 21 21 21 21 21 19 5 5 5 5 5 5 5 5 5 5 5 
5 5 5 5 5 5 5 5 5 5 5 5 5 5 5 5 5 5 5 5 5 5 5 5 5 5 5 5 5 5 5 5 5 5 5 5 5 5 5 5 5 5 5 5 5 5 5 5 5 5 
5 5 5 4 5 5 5 5 4 4 5 5 5 5 5 5 5 5 5 5 5 5 5 5 5 5 5 5 5 5 5 5 5 5 5 4 5 5 5 5 5 5 5 5 5 5 5 5 5 5 
5 5 4 4 5 5 5 5 4 5 5 5 5 5 5 5 5 5 5 5 5 5 5 5 5 5 5 5 5 5 5 4 4 5 5 5 5 5 5 5 5 4 4 5 5 5 5 5 5 5 
5 5 4 5 5 5 5 4 5 5 5 5 5 5 5 5 5 5 5 5 5 5 4 4 4 4 4 5 5 5 5 5 5 5 5 5 5 5 5 5 4 4 4 4 4 4 4 4 4 4 
5 5 4 5 5 5 5 4 5 5 5 5 5 5 5 5 5 5 5 5 5 5 5 5 5 4 4 5 5 5 5 5 5 5 5 5 5 5 5 5 4 5 5 5 4 5 5 5 5 4 
5 5 5 5 5 5 5 4 5 5 5 4 5 5 5 5 5 5 5 5 5 5 5 5 5 4 5 5 5 5 5 5 5 5 5 5 5 5 5 5 4 4 5 5 5 5 5 5 4 4 
5 5 5 5 5 5 5 5 4 4 4 5 5 5 5 5 5 5 5 5 5 5 5 5 5 5 5 5 5 5 5 5 5 5 5 5 5 5 5 5 5 4 4 5 5 5 5 4 4 5 
5 5 5 5 5 5 5 5 5 4 5 5 5 5 5 5 5 5 5 5 5 5 5 5 5 5 5 5 5 4 4 4 5 5 5 5 5 5 5 5 5 5 4 4 4 4 5 5 5 5 
5 5 5 5 5 5 5 5 5 5 5 5 5 5 5 5 5 5 5 5 5 5 5 5 5 5 5 5 5 5 5 4 4 5 5 5 5 5 5 5 5 5 5 5 4 4 5 5 5 5 
